[
   [
      "                                ",
      "                                ",
      "                                ",
      "                                ",
      "   __________________________   ",
      "   ⌈⌉    ⌈⌉ ⌈⌉ ⌈⌉    ⌈⌉    ⌈⌉   ",
      "   ⌈⌉    ⌈⌉ ⌈⌉ ⌈⌉    ⌈⌉    ⌈⌉   ",
      "   ⌈⌉    ⌈⌉ ⌈⌉ ⌈⌉    ⌈⌉    ⌈⌉   ",
      "   ⌋⌊____⌋⌊ ⌈⌉ ⌋⌊____⌋⌊____⌋⌊   ",
      "      ⌈⌉ ⌈⌉ ⌈⌉ ⌈⌉ ⌈⌉ ⌈⌉    ⌈⌉   ",
      "      ⌈⌉ ⌋⌊_⌋⌊_⌋⌊ ⌈⌉ ⌈⌉    ⌈⌉   ",
      "      ⌈⌉ ⌈⌉    ⌈⌉ ⌈⌉ ⌈⌉    ⌈⌉   ",
      "   ___⌋⌊_⌋⌊    ⌈⌉ ⌈⌉ ⌋⌊____⌋⌊   ",
      "   ⌈⌉ ⌈⌉ ⌈⌉    ⌈⌉ ⌈⌉ ⌈⌉ ⌈⌉      ",
      "   ⌈⌉ ⌈⌉ ⌋⌊____⌋⌊_⌋⌊_⌋⌊ ⌈⌉      ",
      "   ⌈⌉ ⌈⌉ ⌈⌉    ⌈⌉    ⌈⌉ ⌈⌉      ",
      "   ⌈⌉ ⌈⌉ ⌈⌉    ⌈⌉    ⌋⌊_⌋⌊___   ",
      "   ⌈⌉ ⌈⌉ ⌈⌉    ⌈⌉    ⌈⌉ ⌈⌉ ⌈⌉   ",
      "   ⌋⌊_⌋⌊_⌋⌊____⌋⌊____⌋⌊ ⌈⌉ ⌈⌉   ",
      "   ⌈⌉    ⌈⌉    ⌈⌉    ⌈⌉ ⌈⌉ ⌈⌉   ",
      "   ⌈⌉    ⌈⌉    ⌈⌉    ⌈⌉ ⌈⌉ ⌈⌉   ",
      "   ⌈⌉    ⌈⌉    ⌈⌉    ⌈⌉ ⌈⌉ ⌈⌉   ",
      "   ⌋⌊____⌋⌊____⌋⌊____⌋⌊_⌋⌊_⌋⌊   ",
      "                                ",
      "                                ",
      "                                ",
      "    (⎽⎽⎽⎽)(⎽⎽⎽⎽)(⎽⎽⎽⎽)(⎽⎽⎽⎽)    "
   ]
]
